Ab=About
Adsg=Absenting
Abb=Abbreviate
Abt=About the
Abbd=Abbreviated
Abty=Ability
Addg=Abbreviating
Abu=Abundant
Abbn=Abbreviation
Aduc=Abundance
Abc=Absence
Abuy=Abundantly
Abd=Aboard
Abv=Above
Adg=Abiding
Aby=Albany
Abh=Abolish
Ac=And Company
Abhd=Abolished
Aca=Academy
Abhg=Abolishing
Acal=Academical
Abhn=Abolition
Acan=Academician
Abi=Abide
Acb=Acceptable
Abj=Abject
Acc=Account
Abjy=Abjectly
Accd=Accounted
Abm=Abominate
Accg=Accounting
Abmd=Abominated
Acct=Accountant
Abmg=Abominating
Acd=Accord
Abml=Abominable
Acdd=Accorded
Abmn=Abominatiion
Acg=According
Abn=Abandon
Acgy=Accordingly
Abnd=Abandoned
Ach=Achieve
Abng=Abandoning
Achd=Achieved
Abnm=Abandonment
Achg=Achieving
Abp=Abrupt
Achm=Achievement
Abpns=Abruptness
Acm=Accumulate
Abpy=Abruptly
Acmg=Accumulating
Abq=Absolute
Acmp=Accompany
Abqy=Absolutely
Acmpd=Accompanied
Abr=Abrogate
Acmpg=Accompanying
Abrd=Abrogated
Acn=Accumulation
Abrg=Abrogating
Aco=Accomodate
Abrn=Abrogation
Acod=Accomodated
Abrv=Abrogative
Acog=Accomodating
Abs=Absent
Acom=Accomodation
Absd=Absented
Acp=Accept
Abse=Absentee
Acpc=Acceptance
Acpd=Accepted
Adl=Admiral
Acpg=Accepting
Adm=Admit
Acph=Accomplish
Admc=Admittance
Acphd=Accomplished
Admd=Admitted
Acphg=Accomplishing
Admg=Admitting
Acphm=Accomplishment
Admn=Admission
Adms=Admits
Acq=Acquaint
Adn=Addition
Acqd=Acquainted
Adnl=Additional
Acqg=Acquainting
Adp=Adopt
Acqs=Acquaints
Adpn=Adoption
Acr=Accurate
Adq=Adequate
Acrly=Accurately
Adqy=Adequately
Acstm=Accustom
Adr=Administer
Acstmd=Accustomed
Adrd=Administered
Actl=Actual
Adrg=Administering
Actly=Actually
Adrn=Administration
Actn=Action
Adrr=Administrator
Actu=Actuate
Adrv=Administrative
Actud=Actuated
Adrx=Administratrix
Actug=Actuating
Ads=Address
Acu=Accuse
Adsd=Addressed
Acud=Accused
Adsg=Addressing
Acug=Accusing
Adss=Addresses
Acun=Accusation
Adt=Amendment
Acup=Acted upon
Adts=Amendments
Acur=Accuser
Adu=Aduce
Acv=Active
Adud=Aduced
Acvs=Activities
Adug=Adducing
Acvly=Actively
Adus=Adduces
Acvty=Activity
Adv=Advertise
Acx=Across
Advc=Advance
Acy=Accuracy
Advcd=Advanced
Ad=Adopted
Advcg=Advancing
Adc=Advice
Advcm=Advancement
Adcs=Advices
Adz=Advise
Adh=Adhere
Adzd=Advised
Adhc=Adherence
Adzg=Advising
Adhd=Adhered
Adzs=Advises
Adhg=Adhering
Aen=Aeronaut
Adht=Adherent
Aep=Aeroplane
Adj=Adqourn
Af=After
Adjd=Adjourned
Afa=Affair
Adjg=Adjourning
Afc=Affect
Adjm=Adjournment
Afed=Affected
Afcg=Affecting
Agrg=Agreeing
Afcn=Affection
Ags=Agents
Afcny=Affectionately
Agt=Agreed to
Afcs=Affects
Agu=Argue
Afd=Afford
Agud=Argued
Addd=Afforded
Agug=Arguing
Afg=Affording
Agum=Argument
Afj=Affidavit
Agup=Argeed upon
Afjs=Affidavits
Agv=Aggressive
Afl=Afflict
Agy=Agency
Afld=Afflicted
Ahd=Apprehend
Aflg=Afflicting
Ahdd=Aprehended
Afln=Affliction
Ahg=Apprehending
Afls=Afflicts
Ahn=Apprehension
Afm=Affirm
Ahv=Apprehensive
Afmd=Affirmed
Aj=Adjust
Afmg=Affirming
Aja=Adjacent
Afmn=Affirmation
Ajd=Adjusted
Afn=Afternoon
Ajg=Adjusting
Afo=Aforesaid
Ajm=Adjustment
Afol=American Federation of Labor
Ajn=Adjoin
Afr=Affray
Ajnd=Adjoined
Afv=Affirmative
Ajng=Adjoining
Afw=Afterward
Ajs=Adjusts
Afx=Affix
Ajt=Adjutant
Afxd=Affixed
Ajts=Adjutants
Afxg=Affixing
Ak=Acknowledge
Ag=Agent
Akc=Access
Aga=Against
Akcy=Accessory
Agb=Agreeable
Akd=Acknowledged
Agc=Agriculture
Akg=Acknowledging
Agd=Agreed
Akm=Acknowledgment
Agg=Aggregate
Aks=Acknowledges
Aggd=Aggregated
Akt=Accident
Aggg=Aggregating
Aktl=Accidental
Aggn=Aggregation
Aktly=Accidentally
Agi=Agitate
Akts=Accidents
Agid=Agitated
Ala=Alabama
Agig=Agitating
Alb=Alberta
Agiv=Agitation
Alc=Alcohol
Agir=Agitator
Ald=Aldermen
Agl=Agricultural
Aldm=Alderman
Aglst=Agriculturist
Alg=Along
Agm=Agreement
Ali=Allv
Agms=Agreements
Alid=Allied
Agn=Again
Alis=Allies
Agr=Agree
Ali=Allege
Aljd=Alleged
Aljg=Alleging
Amtd=Amounted
Aljn=Allegation
Amtg=Amounting
Aljnc=Allegiance
Amts=Amounts
Alk=Alike
Amu=Amuse
Alm=Alarm
Amud=Amused
Almd=Alarmed
Amug=Amusing
Aln=Altercation
Amun=Ammunition
Alnc=Alliance
Amx=Ambitious
Alns=Altercations
Amxy=Ambitiously
Alr=Already
Amz=Amaze
Alt=Alternate
Amzd=Amazed
Altd=Alternated
Amzg=Amazing
Altg=Alternating
Amzm=Amazement
Alty=Alternately
Amzy=Amazingly
Alu=Allude
Anc=Announce
Alud=Alluded
Ancd=Announced
Alug=Alluding
Ancg=Announcing
Alun=Allusion
Ancm=Announcement
Alv=Alternative
Ancs=Announces
Alw=Always
Ang=Antagonist
Ama=America
Angm=Antagonism
Amal=Amalgamated
Angs=Antagonists
Amb=Ambition
Angz=Antagonize
Ambs=Ambitions
Angzd=Antagonized
Amd=Amend
Angzg=Antagonizing
Amdd=Amended
Ank=Anarchist
Amdg=Amending
Anky=Anarchy
Amds=Amends
Anl=Anuual
Amdy=Amendatory
Anly=Annually
Amg=Among
Anm=Animal
Amgst=Amongst
Anms=Animals
Ami=Amicable
Anr=Another
Amily=Amicably
Ant=Anticipate
Amk=Amuck
Amn=American
Antd=Anticipated
Amns=Americans
Antg=Anticipating
Amp=Ample
Antn=Anticipation
Ampy=Amply
Anv=Anniversary
Ampf=Amplify
Anx=Anxious
Ampfd=Amplified
Anxty=Anxiety
Ampfg=Amplifying
Anxy=Anxiously
Ampfn=Amplification
Ao=At once
Amr=Ambassador
Ap=Appropriate
Amrl=Ambassadorial
Apa=Aport
Amrsp=Ambassadorship
Apam=Apartment
Amt=Amount
Apoms=Apartments
Apc=Appreciate
Apcd=Appreciated
Aqn=Acquisition
Apcg=Appreciating
Aqs=Acquires
Apcn=Appreciation
Aql=Acquirable
Apcv=Appreciative
Aqt=Acquit
Apd=Appropriated
Aqtd=Acquitted
Apg=Appropriating
Aqtg=Acquitting
Aph=Approach
Aqtl=Acquittal
Aphd=Approached
Aqts=Acquits
Aphg=Approaching
Aqu=Acute
Aphs=Approaches
Aqw=Acquiesce
Api=Apiece
Aqwc=Aquiescence
Apkn=Application
Aqwd=Acquiesed
Apl=Appeal
Aqwg=Acquiescing
Aplg=Appealing
Aqy=Acutely
Apln=Appelation
Ar=Answer
Apls=Appeals
Ara=Arrange
Aplt=Appelant
Arad=Arranged
Apm=Appointment
Arag=Arranging
Apms=Appointments
Aram=Arrangement
Apn=Appropriation
Arb=Arbitrate
Apns=Appropriations
Arbd=Arbitrated
App=Appoint
Arbg=Arbitrating
Appd=Appointed
Arbm=Arbitrament
Appg=Appointing
Arbp=Archbishop
Apr=Appear
Arbr=Arbitrator
Aprc=Appearance
Arby=Arbitrarily
Arpd=Appeared
Ard=Answered
Aprg=Appearing
Arg=Answering
Aps=Appropriates
Ark=Arkansas
Apt=Apporent
Arl=Artillery
Apty=Apporently
Arn=Arbitration
Apv=Approve
Aro=Arose
Apvd=Approved
Arr=Arrest
Apvg=Approving
Arrd=Arrested
Apvl=Approval
Arrg=Arresting
Apx=Approximate
Ars=Answers
Apxd=Approximated
Arv=Arrive
Apxg=Approximating
Arvd=Arrived
Apxn=Approximation
Arvg=Arriving
Apxs=Approximates
Arvl=Arrival
Apxy=Approximately
Ary=Arbitrary
Apy=Appropriately
Arz=Arizona
Aq=Acquire
Asa=As soon as
Aqc=Acquaintance
Asb=Absorb
Aqd=Acquired
Asbd=Absorbed
Aqg=Acquiring
Asbg=Absorbing
Aqm=Acquirement
Asc=Ascertain
Ascd=Ascertained
Atks=Attacks
Asd=Associated
Atl=Atlantic
Asf=As follows:
Asg=Ascertaining
Atm=Attempt
Asi=Assist
Atmd=Attempted
Asic=Assistance
Atmg=Attempting
Asid=Assisted
Atms=Attempts
Asig=Assisting
Atn=Attention
Asit=Assistant
Atns=Attentions
Asl=Asleep
Atr=Attract
Asm=Assemble
Atrd=Attracted
Asmd=Assembled
Atrg=Attracting
Asmg=Assembling
Atrn=Attraction
Asmj=Assemblage
Atrs=Attracts
Asn=Association
Atrv=Attractive
Aso=Also
Atu=Attitude
Asp=Aspect
Atv=Attentive
Asr=Assert
Atvy=Attentively
Asrd=Asserted
Atx=Atrocious
Asrg=Asserting
Aty=Attorney
Asrn=Assertion
Atyg=Attorney-General
Ast=Associate
Au=Author
Asts=Associates
Aub=Auburn
Asu=Assume
Auc=Auction
Asud=Assumed
Aucnr=Auctioneer
Asug=Assuming
Aucs=Auctions
Asun=Assumption
Aud=Audience
Asus=Assemes
Audm=Auditorium
Asx=Assinate
Auds=Audiences
Asxd=Assassinated
Aug=August
Asxg=Assassinating
Auh=Authentic
Asxn=Assassination
Auhcy=Authenticity
Asy=Assembly
Auhd=Autheenticated
Atb=Attribute
Auhg=Authenticating
Atbd=Attributed
Auhn=Authentication
Atbg=Attributing
Auhs=Authenticates
Atc=Attendance
Auhy=Authentiaclly
Atd=Attend
Aum=Autumn
Atdd=Attended
Aumb=Automobile
Atds=Attends
Aun=Austrian
Atg=Attending
Aup=Auspices
Ath=Athlete
Aupx=Auspicious
Athc=Athletic
Aur=Austria
Athcs=Atletics
Aus=Austrailia
Aths=Athletes
Ausn=Austrailian
Atk=Attack
Aut=Adjourned until to-morrow
Atkd=Attacked
Auv=Authoritative
Atkg=Attacking
Auvy=Authoritatively
Aux=Auxiliary
Awi=Awhile
Auy=Authority
Ax=Ask
Auys=Authorities
Axd=Asked
Auz=Authorize
Axg=Asking
Auzd=Authorized
Axn=Annexation
Augz=Authorizing
Ay=Any
Auzn=Authorization
Ayb=Anybody
Auzs=Authorizes
Ayg=Anything
Av=Average
Ayh=Anyhow
Avb=Available
Aym=Any more
Avd=Averaged
Ayo=Any other
Ave=Avenue
Ay4=Anywhere
Avg=Averaging
Az=Applause
Avin=Aviation
B=Be
Avir=Aviator
Baf=Baffle
Avix=Aviatrix
Bafd=Baffled
avk=advocate
bafg=baffling
avkd=advocated
bafs=baffles
avkg=advocating
baj=badge
avl=avail
bal=balance
avld=availed
bald=balanced
avig=availing
balg=balancing
avls=avails
bap=baptist
avm=averment
bas=byascoreof
avn=aversion
bc=because
avo=avoid
bca=became
avob=avoidable
bch=beach
avod=avoided
bcm=become
avog=avoiding
bd=board
avos=avoids
bdd=boarded
ayr[sic]=aver
bdg=boarding
avrd=averred
bdl=bundle
avrg=averring
bdm=bondsman
avrs=avers
bdmn=bondsmen
avs=averages
bdn=burden
avt=avert
bdr=boarder
avtd=averted
bds=boards
avtg=averting
bdt=bandit
avts=averts
bdy=body
avoy=avoidably
bea=beacon
aw=atwhich
bef=beef
awa=away
beq=bequest
awd=award
bev=beverage
awdd=awarded
bew=bewilder
awdg=awarding
bf=before
awds=awards
bfh=beforehand
awf=awful
bfl=beautiful
awfy=awfully
bkt=breakfast
bfy=beautifully
bnv=benevolent
bg=being
bo=baltimore
bga=began
boe=bankofengland
bgg=baggage
boh=boardofhealth
bgi=begin
bop=breachofpromise
bgig=beginning
bos=boston
bgm=belgium
bot=bought
bgn=bargain
bp=bishop
bgr=burglar
bpc=bishopric
bgt=bright
bq=bequeath
bug=begun
bqd=bequeathed
bgy=burglary
bqg=bequeathing
bh=both
br=british
bhd=behind
brc=brilliance
bhf=behalf
brd=burned
bhv=behave
brf=brief
bi=by
brg=burning
bis=bystander
bri=brilliant
bit=bythe
brk=broke
bj=bound
brl=barrel
bjy=boundary
brm=barometer
bk=break
brn=burn
bkg=breaking
bro=brother
bkn=broken
bry=brilliantly
bkw=backward
brz=breeze
bky=bakery
bs=best
bl=bill
bsp=battleship
bld=build
bsps=battleships
blf=belief
bt=but
blg=building
btk=betake
blk=black
btl=battle
blm=blame
btld=battled
bln=berlin
btlg=battling
blo=blow
btn=between
blt=built
btr=better
blu=blue
bts=bythescoreof
bmb=bombard
bty=battery
bmd=bombarded
bu=bushel
bmg=bombarding
buf=buffalo
bmt=bombardment
buk=book
bn=been
bun=bulletin
bnd=bond
buo=bureau
bnf=benefit
bv=believe
bng=bring
bvd=believed
bnh=beneath
bvg=believing
bnk=bank
bvs=believes
bnl=beneficial
bw=bewith
bwr=beware
bx=brackets[]
bxd=boxed
bxg=boxing
bxr=boxer
bxs=boxes
byd=beyond
bz=business
bzl=brazil
bzln=brazilian
c=see
ca=came
cac=caucus
cacd=caucused
cacg=caucusing
cacs=caucuses
cak=contract
cakd=contracted
cakg=contracting
cakn=cantraction
cal=calculate
cala=california
cald=calculated
calg=calculating
caln=calculation
cap=capital
capz=capitalize
capzd=capitalized
capzg=capitalizing
capzn=capitalization
cau=cause
coud=coused
caug=causing
caus=causes
cav=cavalry
cax=casualties
cay=casualty
cb=celebrate
cba=columbia
cbd=celebrated
cbg=celebrating
cbi=coveredbyinsurance
cbl=cable
cbld=cabled
cblg=cabling
cbls=cables
cbn=celebration
cbs=celebrates
cby=celebrity
cbt=cabinet
ccd=concluded
ccg=concluding
ccl=cancel
ccld=cancelled
ccclg=cancelling
ccln=cancellation
ccn=conclusion
ccsn=concession
ccu=conclude
cd=could
cda=canada
cde=concede
cdd=conceded
cdg=conceding
cdk=contradict
cdkd=contadicted
cdkg=contradicting
cdkn=contradiction
cdm=condemn
cdmd=condemned
cdmg=condumning
cdmn=condemnation
cdn=canadian
cdr=consider
cdrd=considered
cdrg=considering
cdrl=considerable
cdrn=consideration
cdrs=considers
cdry=considerably
cdt=credit
cdtd=credited
cdtg=crediting
cdtr=creditor
cdy=custody
cf=chief
cfc=confidence
cfd=confined
cfg=confining
cfi=confine
cfim=confinement
cfk=confiscate
cfkd=confiscated
cfkg=confiscating
cfkn=confiscation
cfi=confidential
cfly=confidentially
cfm=confirm
cfmd=confirmed
cfmg=confirming
cfms=confirms
cfn=confirmation
cfr=chauffeur
cft=confident
cfty=confidently
cfu=confuse
cfud=confused
cfug=confusing
cfun=confusion
cfus=confuses
cfy=cheifly
cg=seeing
cgm=congressman
cgmn=congressmen
cgn=campaign
cpnd=campaigned
cgng=campaigning
cgns=campaigns
cgs=congress
cgsl=congressional
ch=chicago
cha=china
chad=chamberofdeputies
chc=chance
chcd=chanced
chcg=chancing
chcs=chances
chp=cheap
chpr=cheaper
chr=character
chrc=characteristic
chu=choose
chz=characterize
chzd=characterized
chzg=characterizing
chzn=characterization
chzs=characterizes
cic=commanderinchief
cin=cincinnati
ciq=coronersinquest
cj=coronersjury
cjd=congregated
cjg=congregating
cjl=congregational
cjn=congregation
cjt=congregate
cjx=courageous
cjxy=courageously
ck=check
ckc=coerce
ckl=circle
ckld=circled
cklg=circling
ckls=circles
ckn=coercion
ckt=circuit
cktx=circuitous
ckv=coercive
che=chinese
chg=charge
chgd=charged
chgg=charging
chgs=charges
chh=church
chj=challenge
chjd=challenged
chjg=challenging
chjr=challenger
chjs=challenges
chk=cheek
chm=chairman
chmn=chairmen
chn=children
cho=chose
ckx=committedsuicide
cl=call
cla=class
cld=called
clg=calling
clj=college
cljt=collegiate
clk=clerk
clm=claim
clmd=claimed
clmg=claiming
clms=claims
clo=close
clod=closed
clog=closing
clos=closes
clr=clear
clrd=cleared
clrg=clearing
cls=calls
cly=clearly
cm=come
cmb=combine
cmbd=combined
cmbg=combining
cmbs=combines
cmc=commerce
cmcd=commenced
cmcg=commencing
cmcm=commencement
cmd=command
cmdd=commanded
cmdg=commanding
cmds=commands
cmf=comfort
cmfd=comforted
cmfg=comforting
cmfl=comfortable
cmfs=comforts
cmg=coming
cml=commercial
cmly=commercially
cmm=commission
cmmd=commissioned
cmmg=commissioning
cmms=commissions
cmn=combination
cmp=company
cmps=companies
cmr=commissioner
cmrc=commerce
cmt=commit
cmtd=committed
cmtg=committing
cmtm=commitment
cmts=commits
cmw=commwealth
cmx=circumstance
cmxd=circumstanced
cmxl=circumstantial
cmxs=circumstances
cnc=concern
cncd=concerned
cncg=concerning
cncs=concerns
cnd=condition
cnds=conditions
cnf=confess
cnfd=confessed
cnfg=confessing
cnfn=confession
cnfs=confesses
cng=change
cngd=changed
cngd=changing
cngs=changes
cnl=control
cnld=controlled
cnlg=controlling
cnls=controls
cnq=conquer
cnqd=conquered
cnqg=conquering
cnqr=conqueror
cnqs=conguers
cnr=controller
cnv=convene
cnvd=convened
cnvg=convening
cnvs=convenes
cnx=connsolidate
cnxd=consolidated
cnxg=consolidating
cnxn=consolidation
cnxs=consolidates
co=county
coc=chamberofcommerce
cof=coffee
coi=courtofinquiry
coj=countyjail
col=colonel
com=committee
comm=committeeman
comn=committeemen
con=convention
cop=cheifofpolice
coq=coroner
cot=cotton
cou=country
cous=countries
cow=committeeofthewhole
coz=cousin
cp=constantinople
cpa=capacity
cpb=capable
cpc=compliance
cpd=captured
cpe=catastrophe
cpg=capturing
cpk=complicate
cpkd=complicated
cpkg=complicating
cpkn=complication
cpm=compromise
cpmd=compromised
cpmg=compromising
cpms=compromises
cpn=captain
cpo=compose
cpod=composed
cpog=composing
cpon=composition
cpos=composes
cpr=capture
cpt=complete
cptd=completed
cptg=completing
cptn=completion
cpts=completes
cpu=compute
cpud=computed
cpug=computing
cpun=computation
cpus=computes
cpv=captive
cpvy=captivity
cpy=comply
cpz=capsize
cpzd=capsized
cpzg=capsizing
cpzs=capsizes
cq=correct
cqc=consequence
cqd=corrected
cqg=correcting
cqn=correction
cqs=corrects
cqt=consequent
cqty=consequently
cqy=correctly
cr=care
crc=circulate
crcd=circulated
crcg=circulating
crcn=circulation
crcr=circular
crcs=circulates
crd=cared
crf=careful
crg=caring
crj=carriage
crm=ceremony
crmx=ceremonious
crmxy=ceremoniously
crn=certain
crny=certainly
crp=correspond
crpd=corresponded
crpg=corresponding
crpn=corporation
crpt=correspondent
crs=cares
crt=court
cru=crew
cs=case
csh=cash
cshd=cashed
cshg=cashing
cshr=cashier
csi=consist
csid=consisted
csig=consisting
csis=consists
csit=consistent
csl=counsel
csm=custom
csn=cession
csp=championship
csr=customer
css=cases
cst=contest
cstd=contested
cstg=contesting
csts=contests
csu=consume
csud=consumed
csug=consuming
csun=consumption
csuv=consumptive
csy=customary
ct=connect
ctd=connected
ctf=certificate
ctfn=certification
ctg=connecting
ctm=contempt
ctmb=contemptible
ctn=connection
cts=connects
cty=city
ctz=criticize
ctzd=criticized
ctzg=criticizing
ctzm=criticism
ctzs=criticizes
cu=current
cuj=courage
cul=culminate
culd=culminated
culg=culminating
culn=culmination
culs=culminates
cur=currency
cus=currents
cuy=currently
cv=cover
cvc=convenience
cvd=covered
cvg=covering
cvl=civil
cvk=convoke
cvkd=convoked
cvkg=convoking
cvks=convokes
cvn=civilization
cvt=convenient
cvy=conveniently
cvz=civilize
cvzd=civilized
cvzg=civilizing
cy=copy
cx=capitalletter
cxy=consecutive
czn=citizen
cznsp=citizenship
d=intheorpence
das=days
dau=daughter
db=debate
dbd=debated
dbf=destroyedbyfire
dbg=debating
dbl=debatable
dbr=debater
dbs=debates
dbt=doubt
dc=districtofcolumbia
dca=decay
dcad=decayed
dcag=decaying
dcd=decide
dcdd=decided
dcds=decides
dcg=deciding
dcl=declare
dcld=declared
dclg=declaring
dcln=declaration
dcls=declares
dcn=decision
dcr=december
dcs=decease
dcsd=deceased
dct=districtcourt
dcv=decisive
dd=did
ddc=deduct
ddcd=deducted
ddcg=deducting
ddcn=deduction
ddu=deduce
ddud=deduced
ddug=deducing
ddus=deduces
dduv=deductive
dea=deacon
deb=debris
dec=decrease
decd=decreased
decg=decreasing
decs=decreases
ded=dead
def=defeat
defd=defeated
defg=defeating
defs=defeats
deft=definite
defty=definitely
deg=degree
degs=degrees
del=delegate
dela=delaware
deln=delegation
dels=delegates
dem=democrat
demc=democratic
demy=democracy
dep=deputy
deps=deputies
depz=deputize
des=dispatch
det=debt
df=differ
dfc=difference
dfd=differed
dfdt=defendant
dfg=differing
dfi=deficient
dfm=defame
dfmd=defamed
dfmg=defaming
dfmn=defamation
dfn=definition
dfr=defer
dfrd=deferred
dfrg=deferring
dfs=differs
dft=different
dfty=differently
dfv=defective
dfy=deficiency
dg=doing
dgh=distinguish
dghd=distinguished
dghg=distinguishing
dgt=draught
dh=deadhead
di=direct
dia=diamond
dif=difficult
difs=difficulties
dify=difficulty
dig=directing
din=direction
dir=director
dis=directs
div=dividend
divs=dividends
diz=disease
dizd=diseased
dizs=diseases
dj=deject
djd=dejected
djn=dejection
dk=describe
dkd=described
dkg=describing
dkm=discriminate
dkmd=discriminated
dkmg=discriminating
dkmn=discrimination
dkms=discriminates
dkn=description
dl=deliver
dla=delay
dlad=delayed
dlag=delaying
dlas=delays
dlb=deliberate
dlbd=deliberated
dlbg=deliberating
dlbn=deliberation
dlby=deliberately
dld=delivered
dlg=delivering
dlq=delinquent
dlqy=delinquency
dls=delivers
dly=delivery
dm=demand
dmc=domestic
dmd=demanded
dmg=demanding
dmh=diminish
dmhd=diminished
dmhg=diminishing
dmhs=diminishes
dmlh=demolish
dmn=demonstration
dms=demands
dmt=demonstrate
dmtd=demonstrated
dmtg=demonstrating
dmtr=demonstrator
dmz=demoralize
dmzd=demoralized
dmzg=demoralizing in
dmzn=demoralization
dn=interrogation
dnc=denounce
dncd=denounced
dncg=denouncing
dncn=dunuciation
dng=danger
dngs=dangers
dngx=dangerous
dnl=denial
dnm=denomination
dnr=dinner
doa=departmentofagriculture
doc=document
docs=documents
docy=documentary
doj=departmentofjustice
dol=dollar
dols=dollars
dom=dominion
dos=departmentofstate
dp=depart
dpc=diplomatic
dns=discussion
dsp=desperate
despn=desperation
dsr=desire
dsrd=desired
dsrg=desiring
dss=discusses
dst=disaster
dsv=deserve
dsx=disastrous
dsy=destroy
dsyd=destroyed
dsyg=destroying
dt=donot
dtb=distribute
dtbd=distributed
dtbg=distributing
dtbn=distribution
dtf=doubtful
dth=death
dtm=determine
dtmd=determined
dtmg=determining
dtn=determination
dtr=detract
dtrd=detracted
dtrg=detracting
dtv=detective
dtvs=detectives
du=duty
dub=double
dubd=doubled
dubg=doubling
dup=duplicate
dupd=duplicated
dupg=duplicating
dupn=duplication
dups=duplicates
dur=during
dus=duties
dv=divide
dva=devastate
dvad=devastated
dvag=devastating
dvan=devastation
dvc=device
dpd=departed
dpg=departing
dpk=depict
dpkd=depicted
dpkg=depicting
dpl=disposal
dpm=department
dpms=departments
dpn=disposition
dpo=dispose
dpod=disposed
dpog=disposing
dpr=departure
dps=departs
dpt=diplomat
dpv=deprive
dpy=diplomacy
dq=discover
dqc=divorce
dqcd=divorced
dqce=divorcee
dpcg=divorcing
dqd=discovered
dqg=discovering
dqn=drown
dqr=discoverer
dqs=discovers
dqy=discovery
dr=doctor
drd=doctored
drf=draft
drfs=drafts
drg=doctoring
drl=dreadful
drs=doctors
ds=discuss
dsb=disturb
dsbc=disturbance
dsbd=disturbed
dsbg=disturbing
dsc=distance
dsd=discussed
dsg=discussing
dsi=desist
dsl=dissolve
dsld=dissolved
dslg=dissolving
dsln=dissolution
dvd=divided
dvg=dividing
dvn=division
dvo=devote
dvod=devoted
dvog=devoting
dvon=devotion
dvp=develop
dvpd=developed
dvpg=developing
dvpm=development
dvr=devour
dvrd=devoured
dvrg=devouring
dvs=divides
dvt=divert
dvtd=diverted
dvtg=diverting
dvts=diverts
dw=draw
dwf=dwarf
dwg=drawing
dwl=dwell
dwn=drawn
dwr=drawer
dws=draws
dxn=destruction
dxv=destructive
dny=dynamite
dz=does
ea=each
ebd=embezzled
ebg=embezzling
ebm=embezzlement
ebr=embezzler
ebz=embezzle
ec=ecclesiastic
ecj=encourage
ecjn=encouragement
eck=eccentric
ecl=ecclasiastical
ed=editor
edd=edited
edf=edify
edg=editing
edl=editorial
edn=education
ednl=educational
edt=edit
edu=educate
edud=educated
edug=educating
edv=endeavor
edvd=endeavored
edvg=endeavoring
edw=edward
ef=effect
efd=effected
efg=effecting
efi=efficient
efl=effectual
efly=effectually
efm=effeminate
efo=effort
efos=efforts
efs=effects
efv=effective
efvy=effectively
efy=efficiency
eg=england
ega=engage
egad=engaged
egag=engaging
egam=engagement
egh=english
egm=englishman
egn=englishmen
egp=egypt
egr=eager
egy=eagerly
eh=either
ehb=eitherbe
ehd=eitherinthe
ehf=eitherofthe
ehg=eitherfromthe
eho=eitherof
ehq=eitheronthe
ehr=eitherare
eht=eitherthe
ehu=eitheryou
ehv=eitherofwhich
ehw=eitherwith
ehx=eitherinwhich
ehy=eitheryear
ehz=eitherfromwhich
ej=eject
eja=ejaculate
ejad=ejaculated
ejag=ejaculating
ejan=ejaculation
ejd=ejected
ejg=ejecting
ejm=ejectment
ejn=ejection
ejo=enjoy
ejod=enjoyed
ejog=enjoying
ejom=enjoyment
ejs=ejects
ek=economy
ekc=economic
ekl=economical
eks=economics
ekz=economize
el=elect
elc=electric
elcl=electrical
elcn=electrician
elcy=electrically
elcu=electrocute
elcud=electrocuted
elcug=electrocuting
elcum=electrocution
elb=elaborate
elbn=elaboration
eld=elected
elg=electing
elj=elligible
eljy=eligibility
elm=eliminate
elmd=eliminated
elmg=eliminating
elmn=elimination
ehq=either on the
eln=election
ehr=either are
elo=elope
eht=either the
elod=eloped
ehu=either you
elog=eloping
ehv=either of which
elom=elopment
ehw=either with
elq=eloquent
ehx=either in which
elqc=eloquence
elqy=eloquently
enj=enjoin
elr=elector
enjd=enjoined
els=elects
enjng=enjoining
elt=element
enjm=enjoyment
elts=elements
enm=entertainment
elty=elementary
eno=enormous
elu=elude
enoy=enormously
elv=elective
enr=enter
enrd=entered
em=embarrass
enrg=entering
ebm=embrace
ent=entertain
embd=embraced
entd=entertained
embg=embracing
entg=entertaining
embt=embracement
enu=enumerate
emc=emphatic
enud=enumerated
ency=emphatically
enug=enumerating
emd=embarrassed
enun=enumeration
emg=embarrassing
env=envelope
emi=emigrate
envd=enveloped
emid=emigrated
envg=enveloping
emig=emigrating
envm=envelopment
emj=emergent
eny=enthusiastically
emjy=emergency
enz=enterprise
emm=emigration
enzg=enterprizing
emo=emotion
epd=employed
emp=empty
epg=employing
empd=emptied
epe=employe
empg=emptying
epl=episcopal
emt=embarrassment
epm=employment
emy=embody
epn=episcopalian
emyd=embodied
epr=employer
emyg=embodying
epy=employ
emym=embodyment
eq=enquire
emz=emphasize
eqb=equable
emzd=emphasized
eqd=equalled
emzg=emphasizing
eqg=equaling
en=enthusiasm
eqk=earthquake
enn=enable
eql=equal
enc=enthusiastic
eqls=equals
enf=enforce
eqm=equipment
enfd=enforced
eqp=equip
enfg=enforcing
eqps=enquires
enfm=enforcement
eqv=equivalent
eng=engine
eqy=enquiry
engr=engineer
eqz=equalize
engrd=engineered
eqzd=equalized
engrg=engineering
eqrg=equalizing
enh=enough
eqrn=equalization
er=error
exbd=exhibited
ers=errors
exbg=exhibiting
erx=erroneous
exbn=exhibition
erxy=erroneously
exc=excess
es=and
exd=expected
esb=establish
exg=exchange
esbd=established
exk=expect
esbg=establishing
exkg=expecting
esbs=establishes
exkn=expectation
esc=and so forth
exm=examine
esd=and in the
exmd=examined
esk=escape
exmg=examining
eskd=escaped
exn=examination
eskg=escaping
exp=express
eskm=escapement
expd=expressed
esl=essential
expg=expressing
esls=essentials
expn=expression
esly=essentially
exq=excuse
esm=establishment
exqd=excused
esp=especial
exqg=excusing
espy=especially
exgs=excuses
esq=esquire
exr=examiner
esr=and are
exrs=examiners
est=and the
exv=excessive
etc=etcetera
ey=every
etd=estimated
eyb=everybody
etg=estimating
eyg=everything
etm=estimate
ey4=everywhere
etn=estimation
f=of the
fa=fail
fab=fabric
fac=fact
facn=faction
facr=factor
fad=failed
fag=failing
fam=family
fap=filed a petition
fapib=filed a petition in bankruptcy
fas=fails
fau=failure
fav=favor
fax=facts
fb=of the bill
fbl=favorable
fbo=fire broke out
fbx=fabulous
fc=fiscal
fcd=financed
fcg=financing
fce=finance
fch=french
fcl=financial
fcly=financially
fcr=financier
fcs=finances
fd=find
fdc=federal court
fdd=federated
fdg=finding
fdl=federal
fdm=fundamental
fdn=federation
fdr=finder
fds=finds
fea=feather
feb=february
fem=feminine
fev=fever
ffj=fugitive from justice
ffr=philosopher
ffy=philosophy
fg=following
fgh=photograph
fghd=photographed
fghg=photographing
fghr=photographer
fgm=fragment
fgms=fragments
fgmy=fragmentary
fgn=foreign
fgnr=foreigner
fgo=following order
fgr=figure
fgd=figured
fgg=figuring
fh=forth
fhr=further
fhw=forthwith
fi=fire
fid=fired
fig=firing
fin=finish
fj=found
fjd=founded
fjg=founding
fjn=foundation
fjr=founder
fjy=foundry
fk=fluctuate
fkd=fluctuated
fkg=fluctuating
fkn=fluctuation
fks=fuuctuates
fkx=fictitious
fky=factory
fl=feel
fla=flame
flas=flames
fld=field
fldd=fielded
fldg=fielding
flds=fields
flg=feeling
flh=flourish
flhd=flourished
flhg=flourishing
flhs=flourishes
flo=flow
flod=flowed
flog=flowing
flos=flows
fls=feels
flz=fertilize
flzd=fertilized
flzg=fertilizing
flzr=fertilizer
fm=from
fmd=formed
fmg=forming
fml=formal
fmly=formally
fmn=formation
fmr=former
fmy=formerly
fmx=famous
fn=fifteen
fna=fanatic
fnc=france
fnd=friend
fndsp=friendship
fnh=furnish
fnhd=furnished
fnhg=furnishing
fnhs=furnishes
ftm=for the murder
ftp=for the purpose
ftu=feature
fnk=frank
fty=fatally
fnl=funeral
fu=few
fnt=front
fug=fugitive
fny=funny
fui=fully insured
fnz=frenzy
fut=future
fo=for
fv=five
foj=fourth of july
fvh=fifth
fot=fought
fvt=favorite
fou=fourteen
fw=follow
fp=philanthropist
fwd=followed
fpc=philanthropic
fx=fort
fpy=philanthropy
fxd=fixed
fq=frequent
fxg=fixing
fqd=frequented
fxn=fortification
fqg=frequenting
fxs=forts
fqs=frequents
fxy=fortify
fqy=frequently
fym=furthermore
fr=four
fyn=fortune
frc=force
fyt=fortunate
frcd=forced
fz=freeze
frcg=forcing
fzn=frozen
frd=fraud
frdt=fraudulent
g=from the
ga=gave
gad=guaranteed
gag=guaranteeing
gal=gallon
gals=gallon
gar=guarantee
gau=gauge
gay=guaranty
gb=great britian
gc=grace
gcl=graceful
gcx=gracious
gcy=gracefully
gd=good
gds=goods
gen=general
gens=generals
geny=generally
yd=yield
ydg=yielding
gery=germany
gov=governor
gf=gulf
gp=group
gfd=gratified
gpd=grouped
gfg=gratifying
gpg=grouping
gfn=gratification
gps=groups
gfy=gratify
gq=geology
gg=going
gql=geological
gh=gather
gqt=geologist
ghd=gathered
gr=ground
ghg=gathering
grd=grounded
ghs=gathters
grf=greif
gi=gigantic
grg=grounding
gj=grand jury
grn=grain
gk=greek
grs=grounds
gks=greeks
grv=greive
gl=girl
grvd=grieved
glc=glance
grvg=grieving
glcd=glanced
gs=guess
glcg=glancing
gsd=guessed
gld=gold
gsg=guessing
glm=gleam
gsp=gossip
glmd=gleamed
gspd=gossipped
glmg=gleaming
gspg=gossipping
glms=gleams
gt=great
gln=glean
gtg=getting
glnd=gleaned
gtr=greater
glng=gleaning
gty=greatly
glns=gleans
gu=guard
gls=girls
gubl=guernatorial
glv=glove
gud=guarded
glvs=gloves
gug=guarding
glx=glorious
gus=guards
gm=gentleman
gv=give
gmn=gentlemen
gvc=grievance
gms=gentlemans
gvg=giving
gmy=gentlemanly
gvn=given
gn=gone
gvt=government
gnd=grand
gw=grow
gni=good night
gwg=growing
gno=gave notice
gwh=growth
gnt=grant
gwn=grown
gntd=granted
gws=grows
gntg=granting
gx=great excitement
gnts=grants
gy=guilty
gnx=generous
gz=gazette
gnxy=generously
gzd=gazetted
goh=guest of honor
gzr=gazetteer
h=has
hnd=hundred
hag=haggle
ho=hold
hagd=haggled
hog=holding
hagg=haggling
hom=home
hags=haggles
homs=homes
hap=happy
hon=honorable
hb=has been
hor=holder
hbr=harbor
hos=holds
hbrd=harbored
hox=hostilities
hbrg=harboring
hoy=hostility
hbrs=harbors
hp=hope
hc=habeas corpus
hpd=hoped
hd=had
hpf=hopeful
hdb=had been
hpg=hoping
hed=head
hpl=hopeless
hes=hesitate
hpn=happen
hesd=hesitated
hpnd=happened
hesn=hesitation
hpns=happens
hf=half
hps=hopes
hg=having
hqrs=headquarters
hgb=having been
hh=has had
hrd=heard
hhd=hogshead
hrf=heretofore
hi=high
hrg=hearing
hib=hibernian
hrl=hurl
hin=hinder
hrld=hurled
hir=higher
hrlg=hurling
hk=hook
hrm=harm
hkd=hooked
hrmd=harmed
hkg=hooking
hrmg=harming
hkn=hurricane
hrms=harms
hkp=handicap
hrt=hurt
hks=hooks
hrtg=hurting
hl=hell
hrv=harvest
hlh=health
hrvd=harvested
hlp=help
hrvg=harvesting
helpd=helped
hrvr=harvester
hlpg=helping
hrvs=harvests
hly=healthy
hrw=herewith
hm=him
hry=hurry
hmx=harmonious
hs=his
hmy=harmony
hsb=husband
hn=has not
hsf=himself
hnb=has not been
hsp=hospital
hnc=hence
ht=has the
htl=hotel
ict=inconvenient
hu=house
icu=include
hub=house bill
icud=included
huc=house committee
icug=including
hud=hudson
icun=inclusion
hul=house of lords
icus=includes
huq=house of commons
icv=inconvenience
hur=house of representatives
icw=in connection with
hv=have
ida=idaho
hvb=have been
idc=induct
hvnb=have not been
idcd=inducted
hvk=havoc
idcg=inducting
hvr=however
idcn=induction
hvu=have you
idd=introduced
hvy=heavy
idf=identify
hw=how
idfd=identified
hx=hyphen
idfg=identifying
hy=henry
idfn=identification
hz=hazard
idg=introducing
hzd=hazarded
idm=indictment
hzg=hazarding
idn=introduction
hzx=hazardous
idt=indict
ia=iowa
idtd=indicted
iab=introduced a bill
idtg=indicting
ian=indian
idty=identify
iar=introduced a resolution
idu=induce
idad=initiated
idud=induced
iat=in addition to
idug=inducing
iaw=in accordance with
idum=inducement
ibo=in behalf of
idy=introductory
ic=in connection
ifc=inference
icc=interstate commerce commission
ifd=informed
icg=in concluding
ifg=informing
icj=intercollegiate
ifl=informal
icm=income
ifm=inform
icmg=incoming
ifn=information
icms=incomes
ifo=in favor of
icn=in conclusion
ifq=infrequent
icp=incorporate
ifqy=infrequently
icpd=incorporated
ifr=infer
icpg=incorparating
ift=inflict
icpn=incorporation
iftd=inflicted
ifty=inflicting
ifts=inflicts
ify=infantry
imn=immigration
ig=indignant
imnt=imminent
igc=ignorance
imp=import
igl=illegal
impd=imported
ign=indignation
impg=importing
igt=ignorant
impn=importation
igy=indignantly
imps=imports
ih=it has
imt=immediate
iho=in honor of
imv=imaginative
ij=injure
ina=initiate
ijc=intelligence
inad=initiated
ijd=injured
inag=initiating
ijg=injuring
inav=initiative
ijn=injunction
inas=initiates
ijs=injures
inc=increase
ijt=intelligent
incd=increased
ijx=injurious
incg=increasing
ijy=injury
incs=increases
ik=instantly killed
ind=indiana
ikd=indicated
inf=influence
ikg=indicating
infl=influential
ikm=incriminate
inj=injustice
ikmd=incriminated
inl=international
ikmg=incriminating
ino=innocent
ikmn=incrimination
inoc=innocence
ikms=incriminates
inp=independent
ikn=indication
inpy=independently
iks=indicates
inq=inquest
iku=incumbent
ins=insurance
ikv=indicative
instn=institution
ild=illustrated
instu=institute
ilg=illustrating
instd=instituted
iln=illustration
instg=instituting
ils=illustrates
insx=instantaneous
ilt=illustrate
int=interest
ilv=illustrative
intd=interested
ilx=illustrious
intg=interesting
im=immediately
inu=innumerable
ima=imagine
inv=involve
iman=imagination
invd=involved
imd=imagined
invg=involving
img=imagining
inx=instruct
imi=immigrate
inxd=instructed
imid=immigrated
inxg=instructing
imig=immigrating
inxn=instruction
imm=immense
inxs=instructs
immy=immensely
iny=incendiary
inys=incendiaries
isi=insist
io=in order
isjt=insurgent
iot=in order to
isjts=insurgents
ip=improve
isjy=insurgency
ipc=importance
isn=island
ipd=improved
iso=in spite of
ipg=improving
ista=interstate
ipk=implicate
isu=issue
ipkd=implicated
isuc=issuance
lpkg=implicating
isud=issued
ipkn=implication
isug=issuing
ipm=improvement
isus=issues
ipn=imposition
isw=in sympathy with
ipo=impose
isxn=insurrection
ipod=imposed
ipog=imposing
itc=in this connection
ips=improves
itd=intend
ipt=important
itdd=intended
ipu=impute
itg=intending
ipud=imputed
itf=interfere
ipug=imputing
itfd=interfered
ipun=imputation
itfg=interfering
ipus=imputes
itn=intention
ipx=inspect
itx=intoxicate
ipxd=inspected
itxd=intoxicated
ipxg=inspecting
itxg=intoxicating
ipxn=inspection
itxn=intoxication
ipxs=inspects
iug=inaugurate
iugd=inaugurated
iugg=inaugurating
iq=inquire
iul=industrial
iqd=inquired
iun=inauguration
iqg=inquiring
iup=interrupt
iqn=inquisition
iupd=interrupted
iqo=in consequence of
iupg=interrupting
iqr=inquirer
iupn=interruption
iqs=inquires
iux=industrious
iqy=inquiry
iuxy=industrously
ir=irregular
iuy=industry
ird=ireland
iuys=industries
irh=irish
iv=in view
irl=internal
iva=invade
irn=iron
ivad=invaded
irs=irregularities
ivag=invading
irt=in regard to
ivan=invasion
iry=irregularly
ivas=invades
isc=instance
ivd=investigated
iscd=instanced
ivg=investigate
iscg=istancing
ivgg=investigating
iscs=instances
ink=invoke
ivkd=invoked
ivkn=invocation
ivl=individual
ivm=investment
ivn=investigation
ivo=in view of
ivs=invest
ivsd=invested
ivsg=investing
ivt=invite
ivtd=invited
ivtg=inviting
ivtn=invitation
ivts=invites
ivu=interview
ivud=interviewed
ivug=interviewing
iw=it was
iwb=it was believed
iwc=it was claimed
iwf=it was feared
iwh=it was held
iwj=it was alleged
iwn=it was not
iwr=it was reported
iwu=it was understood
iwx=it was expected
ix=it is
ixb=it is believed
ixc=it is claimed
ixf=it is feared
ixh=it is held
ixj=it is alleged
ixn=it is not
ixp=it is possible
ixr=it is reported
ixs=it is said
ixt=it is the
ixu=it is understood
ixx=it is expected
j=by whiche
jan=january
jas=james
jb=jubilee
jbn=jubilation
k=out of the
kg=king
kah=knots an hour
kan=kansas
kb=contribute
kbd=contributed
kbg=contributing
kbn=contribution
kbs=contributes
kc=concentrate
kcd=concentrated
kcg=concentrating
kcl=conciliate
kcld=conciliated
kclg=conciliating
kcln=conciliation
kcls=conciliates
kcn=concentration
kcs=concentrates
kcx=conscious
kcxn=consciousness
kd=kind
kdc=conduct
kdcd=conducted
kdcg=conducting
kdcr=conductor
kdg=knowledge
kdn=kindness
kdu=conduce
kdud=conduced
kdug=conducing
kdus=conduces
kdy=kindly
kf=confer
kdc=conference
kfd=conferred
kfe=conferee
kfg=conferring
kfm=conform
kfmd=conformed
kfmg=conforming
kfms=conforms
kfmy=conformity
kfs=confers
kft=conflict
kftd=conflicted
kftg=conflicting
kfts=conflicts
kfw=confer with
knp=contemplate
knpd=contemplated
knpg=contemplating
knpn=contemplation
knps=contemplates
kns=converse
knsd=conversed
knsg=conversing
knv=conversation
knx=conscientious
kny=conscientiously
ko=colon
kol=column
kom=common
kop=co operate
kopd=co operated
kopg=go operating
kopn=co operation
kp=keep
kpd=comprehend
kpg=keeping
kpl=compel
kpn=competition
kpr=conspire
kprd=conspired
kprg=conspiring
kpt=compete
kptd=competed
kptg=competing
kptr=competitor
kptv=competitive
kpv=coomprehensive
kpx=conspicuous
kpy=conspiracy
kq=quotation
kqc=convince
kqcd=convinced
kqd=convicted
kqn=conviction
kgq=convects
kqt=convict
kr=color
krb=corroborate
krbd=corroborated
krbg=corroborating
kw=know
kwg=knowing
kws=knows
kxc=construct
kxd=constructed
kxg=constructing
kxn=construction
kxs=constructs
ky=kentucky
kyn=kentuckian
kz=consult
kzd=consulted
kzg=consulting
kzn=consultation
kzs=consults
la=louisiana
lab=labor
labd=labored
labg=laboring
labs=labors
laby=laboratory
laf=laugh
lag=language
lan=lousianian
las=last
lat=latitude
lav=lavish
lavd=lavished
lavg=lavishing
lavy=lavishly
lbl=liberal
lbr=lumber
lbx=laborious
ld=london
ldg=leading
ldr=leader
lea=leather
lf=life
lfb=file boat
lfi=life insurance
lfr=laughter
lg=long
lgd=longed
lgg=longing
lgl=legal
lgr=longer
lvs=leaves
lw=law
lwf=lawful
lwl=lawless
lwr=lawyer
lx=pounds sterling
lyg=lying
m=more
mab=may be
mag=magnificent
mah=miles an hour
maj=major
mam=mammoth
mar=march
mas=massachusetts
mat=material
max=maximum
mbz=mobilize
mbzn=mobilization
mch=machine
mck=mechanic
mcl=mechanical
mcn=mechanician
mcy=machinery
md=made
mda=monday
mdf=modify
mdfn=modification
mdg=middling
mdl=middle
mdm=medium
mdn=moderation
mdt=moderate
mdy=moderately
mdz=merchandise
me=maine
med=mediterranean
mem=member
mf=manufacture
mfd=manufactured
mfg=manufacturing
mfr=manufacturer
mfs=manufactures
mfy=manfactory
mg=manage
mgd=managed
mgg=managing
mgm=management
mos=months
moy=monthly
mpc=monopolistic
mpd=manipulated
mpg=manipulating
mpn=manipulation
mpon=metropolitan
mpu=maipulate
mpy=monopoly
mpz=monapolize
mr=mister
mrd=married
mrg=mortgage
mrj=marriage
mrl=marshal
mrv=marvel
mrvx=marvelous
mry=marry
ms=most
msd=missed
msg=missing
msj=message
msjr=messenger
msk=mistake
mskn=mistaken
msn=mission
msny=missionary
msp=mississippi
msr=measure
msrd=measured
msrg=measuring
msrm=measurement
mst=must
msy=mostly
mt=meet
mtg=meeting
mtn=mountain
mtr=matter
mts=meets
mty=materially
mtz=materialize
mtzn=materialization
mu=murder
mud=murdered
mug=murdering
mun=municipal
mur=murderer
mus=murders
nec=necessary
neg=negative
nev=nevada
nf=notify
nfd=notified
nfg=notifying
nfk=norfolk
nfn=notification
ng=negotiate
ngd=negothiated
ngg=negotiating
ngn=negotiation
ngs=negotiates
nh=new hampshire
ni=night
nik=nicaragua
nj=new jersey
nl=natural
nly=naturally
nlz=naturalize
nlzn=naturalization
nm=nominate
nmd=nominated
nme=nominee
nmg=nominating
nml=nominal
nmn=nomination
no=new orleans la
nor=normal
nov=november
nr=near
nrv=nerve
nry=nearly
nt=north
ntc=notice
ntg=nothing
ntn=northern
ntr=neither
ntx=notorious
nty=northerly
nu=new
num=number
numd=numbered
numg=numbering
nums=numbers
nup=newspaper
nus=news
nux=numerous
ogd=organized
ogg=organizing
ogl=original
ogn=organization
ogs=organizes
ogt=on the ground that
ogy=originally
oh=ohio
oht=ought
oj=object
ojd=objected
ojg=objecting
ojl=objectionable
ojn=objection
ojs=objects
ojv=objective
oko=of course
om=omit
omd=omitted
omg=omitting
omn=omission
omo=on motion of
oms=omits
ond=owned
onr=owner
ont=ontario
op=opportunity
opd=opened
opg=opening
opn=opinion
opr=operator
ops=opportunities
opt=opponent
opu=opportune
oq=eccupy
oqd=occupied
oqg=occupying
ojn=occupation
oq=occupies
oqt=occupant
oqy=occupancy
ory=ordinary
os=oppose
osd=opposed
osg=opposing
osn=opposition
pcpn=participation
pcpt=participant
pct=precipitate
pctd=precipitated
pctg=precipitating
pctn=precipitation
pcts=precipitates
pcu=preclude
pcud=precluded
pcug=precluding
pcus=precludes
pcv=perceive
pcvd=perceived
pcy=practically
pd=paid
pdc=precedence
pdd=preceeded
pde=precede
pdg=preceding
pdk=predict
pdkd=predicted
pdkg=predicting
pdkn=prediction
pdm=predominate
pmd=predominated
pdmg=predominating
pdn=production
pdr=predecessor
pdt=precedent
pdu=produce
pdud=produced
pdug=producing
pdus=produces
pdut=product
pdv=productive
pe=principle
pedn=pedestrian
pem=presented a memorial
peny=penitentiary
peo=people
pep=presented a petition
pjs=prejudices
pnr=prisoner
pjt=project
pnt=point
pjtd=projected
pnx=precencts
pjtg=projecting
pny=principally
pjy=perjury
po=post office
pk=particular
pod=post office department
pkg=packing
partment
pkj=package
pog=postage
pkm=predicament
pon=position
pks=particulars
pop=popular
pku=peculiar
popn=population
pkuly=peculiarly
pos=possible
pkuy=peculiarity
posy=possibly
pky=particularly
pot=president of the
pkz=particularize
potus=president of the united states
plf=platform
pln=politician
plny=preliminary
plm=parliament
plmy=parliamentary
pls=please
plsr=pleasure
plx=politics
ply=politically
pm=postmaster
pma=panama
pmac=panama canal
pmo=prominence
pmg=postmaster general
pmn=proclamation
pmnt=prominent
pmp=peremptory
pmpy=peremptorily
pmsl=permissible
pmsn=permission
pmt=permit
pmtd=permitted
pmtg=permitting
pmy=prominently
pnc=pronounce
pncd=pronounced
pncg=pronouncing
pncn=pronunciation
png=pending
pnl=principal
pnpy=plenipotentiary
pr=president
prm=permanent
prn=prison
prp=proper
prpn=proportion
pud=published
prs=presidents
pug=publishing
prty=party
puh=publish
pry=presidency
puhr=publisher
pum=publication
ps=pass
psd=passed
psc=persistence
psg=passing
psi=persist
psid=persisted
psig=persisting
psis=persists
psit=persistent
psj=passage
psk=prospect
pskd=prospected
pskg=prospecting
pskv=prospective
psl=personal
psn=person
psnl=personnel
pspx=prosperous
pspy=prosperity
psq=prosecute
psqd=prosecuted
pqqg=prosecuting
psqn=prosecution
pss=passes
psu=presume
psud=presumed
psug=presuming
psun=presumption
psuy=presumably
psv=passive
psy=personally
pt=present
ptc=pretence
ptd=presented
ptg=presenting
ptm=presentment
ptn=presentation
ptr=presenter
pts=presents
pty=presently
pu=public
pucy=publicity
pz=prize
pzd=prized
pzg=prizing
pzn=poison
pznd=poisoned
pzng=poisining
pzr=poisoner
pzs=prizes
q=on the
qa=quality
qad=qualified
qag=qualifying
qan=jualification
ray=quality
qb=on the bill
cq=concur
qcc=concurrence
qcd=concuurred
qcg=concurring
qcs=concurs
qct=concurrent
qk=quick
qky=quickly
qm=quartermaster
qmg=quartermaster general
qny=quantity
qco=on the contrary
qoh=on the other hand
qom=quorum
qow=on the whole
qp=on the part of
qpt=on the part of the
qq=on the question
qr=quarter
qrd=quartered
qrg=quartering
qrl=quarrel
qrs=quarters
qry=quarterly
qrz=quartz
qsd=questioned
qsg=questioning
qsh=quash
qsn=question
qso=quite so
qt=quite
qtn=quotation
regn=registration
regr=registrar
regs=registers
rek=wreck
rekj=wreckage
rept=repeat
repd=repeated
repg=repeating
reptn=repetition
req=request
reqd=requested
reqd=requesting
reqs=requests
rev=reverend
rf=refer
rfc=reference
rfd=referred
rfe=referee
rfg=referring
rfk=reflect
rfkd=reflected
rfkg=reflecting
rfkn=ferlection
rfm=reform
rfn=reformation
rfr=reformer
rfs=refers
rfu=refuse
rfud=refused
rfug=refusing
rfum=referendum
rg=regular
rgd=regard
rgdd=regarded
rgdg=regarding
rgds=regards
rgm=regiment
rgn=regulation
rgs=regulars
rgt=regulate
rgy=regularly
rh=reach
rhd=reached
rhg=reaching
rhr=rather
rhs=reaches
rht=right
ri=rhode island
rmd=remained
rmg=remaining
rmk=remark
rmkd=remarked
rmkg=remarking
rmn=rumuneration
rmr=rumor
rmrd=rumored
rmrg=rumoring
rms=remains
rmt=remit
rmu=remunerate
rmv=remunerative
rmx=remarks
rn=reason
rnc=ronounce
rncd=renounced
rncg=ronouncing
rnd=reasoned
rnf=reinforce
rnfm=reinforcement
rng=reasoning
rnl=reasonable
rnu=renew
rny=reasonably
ro=rose
rog=re organize
rogd=re organized
rogg=re organizing
rogn=re organization
rot=report of the
rp=report
rpb=rosponsible
rpby=responsibility
rpc=republic
rpd=reported
rpg=reporting
rph=reproach
rphd=reproached
rphg=reproaching
rpl=repeal
rpld=repealed
rplg=repealing
rpls=repeals
rpm=re-appointment
rpn=republican
rpr=reporter
rsud=resumed
rsug=resuming
rzs=results
rsum=resumption
rzt=resultant
rsv=reserve
rsvd=reserved
rsvg=reserving
rsvn=reservation
rt=are the
rtd=returned
rtg=returning
rtn=return
ru=are you
ruf=rough
rup=rupture
rupd=ruptured
rupg=rupturing
rus=russia
rv=remove
rvd=removed
rvg=removing
rvk=revoke
rvkd=revoked
rvkg=revoking
rvkn=revocation
rvl=removal
rvn=revolution
rvo=revolve
rvod=revolved
rvog=revolving
rvos=revolves
rvor=revelver
rvr=river
rvs=remones
rvt=revolt
rvu=review
rvy=revolutionary
rwd=reward
rwdd=rewarded
rwdg-s=rewarding
lwds=rewards
rx=recommend
rxd=recommended
rxg=recommending
rxn=recommendation
rxs=recommends
ry=railway
rz=result
rzd=resulted
rzg=resulting
sdug=seducing
sdun=seduction
sdus=seduces
sdy=sunday
se=from which
sec=section
sed=said
seg=saying
sem=seem
sen=seen
sep=september
ses=says
sey=secretary
sf=satisfy
sfd=satisfied
sfg=satisfying
sfj=suffrage
sfjt=suffragette
sfly=satisfactorily
sfn=satisfaction
sfr=nuffer
sfy=satisfactory
sg=signify
sgc=significance
sgd=signified
sgg=signifying
sghr=stenographer
sgn=signification
sgt=significant
skg=stenography
sh=such
shf=sheriff
skk=shake
shl=shall
shr=share
si=semicolon
sig=signature
sil=silver
sim=similar
sip=said in part
sis=sister
siu=situate
siud=situated
siug=situating
siun=situation
sj=subject
sjd=subjected
sjg=subjecting
soun=southern
sov=soverign
sovy=soverignty
sow=secrotary of war
soy=society
sp=ship
spa=spacious
spb=shipborad
spd=shipped
spfc=specific
spfd=specified
spfg=specifying
spfn=specification
spfy=specify
spg=shipping
sph=speech
spk=spoke
spkg=speculating
spkr=speculator
spku=speculate
spkun=speculation
spkv=speculative
spl=special
spm=shipment
spn=suspicion
spo=suppose
spod=supposed
spog=suppposing
spon=supposition
spq=speak
spqg=speaking
spqr=speaker
spr=shipper
spt=support
sptr=supporter
spx=suspicious
spz=surprise
sq=separate
sqd=separated
sqg=separating
sqn=separation
sqr=square
sqa=separates
sr=secure
srd=secured
srg=securing
supr=superior
supt=superintendent
sux=sucurities
suy=saturday
sv=seven
svc=service
svd=served
sve=serve
svg=serving
svh=seventh
svl=several
svr=severe
svt=servant
svy=severely
sw=swear
swg=swearing
swn=sworn
swo=swore
sws=swears
sx=dollar mark
sxh=sixth
sxl=sexual
sxm=settlement
sxn=sensation
sxnl=sensational
syc=systemitic
syl=systematical
sym=symptom
syn=syndicate
sys=system
syz=systematize
sz=seize
szd=seized
szg=seizing
szn=season
szr=seizure
szs=seizes
t=the
tam=the amendment
tan=than
tau=to authorize
tb=the bill
tbc=tobacco
tbd=the board
tbh=to be held
tbl=trouble
tbx=tuberculosis
tbz=the business
thq=thick
thr=their
thru=through
tht=thought
thu=the house
ti=time
tj=the jury
tjg=the judge
tk=take
tkg=taking
tkh=turkish
tkn=taken
tkr=taker
tkt=ticket
tky=turkey
tm=them
tmp=temperature
tmd=transmitted
tmg=transmitting
tmn=transmission
tmt=transmit
tmx=tremendous
tn=then
tnc=thence
tnd=thousand
tni=to-night
tnk=think
tnm=tournament
tnv=tentative
tnvy=tentatively
tny=tendency
tol=tolerate
tp=transport
tpd=transported
tpg=transporting
tph=telephone
tpn=transportation
tpo=the passage of
tpy=temporary
tq=the question
tqls=tranquil
tqo=the question of
tqy=tranquilly
tr=there
trd=third
tre=three
trf=therefore
trk=track
u=you
uac=unaccepted
unx=unexpected
uau=unauthorized
uny=unexpectedly
uav=unavoidable
uoc=unchanged on call
ubd=undoubted
ubq=ubiquitous
upn=upon
uby=undoubtedly
upt=unimportant
uc=you see
upw=upward
ucm=uncommon
uq=upon the
ucn=uncertain
uqq=upon the question
ucx=unconscious
ucxn=unconsciousness
ur=your
ucy=unnecessary
us=united states
udf=unidentified
usa=united states of america
uf=unfortunate
usf=useful
ufb=unfavorable
usg=united states government
ufby=unfovorably
usk=unsuccessful
ufd=unfounded
utaf=under the auspices of the
ufm=uniform
utc=under the circumstances
ufp=under false pretenses
utd=uttered
ufy=unfortunately
utr=utter
ugd=unchanged
uty=utterly
ugt=urgent
utz=utilize
ugud=unguarded
uv=universe
uguy=ungardedly
uvl=universal
ugy=urgently
uvy=university
uk=understand
ux=underline 
ukd=understood
uxc=under these circumstances
ukg=understanding
ul=usual
ukn=unkoown
ulm=ultimate
uky=understandingly
ult=ultimo
uxl=unconstitutional
uly=usually
uxty=unconstitutionality
um=unanimous
uzy=unconstitutionally
umf=unmanufactured
v=of which
ump=umpire
va=virginia
umy=unanimously
vac=vacate
un=until
vad=vacated
und=under
vag=vague
ung=young
vak=vacant
uni=united
val=value
unj=unjust
var=various
unl=unless
vax=vaccinate
uns=unsettled
vay=variety
unu=unusual
unuy=unusually
vb=valuable
vsd=visited
vby=valuably
vsg=visiting
vcd=vindicated
vsn=vision
vcg=vindicating
vsr=visitor
vcn=vindication
vst=visit
vct=vindicate
vt=vermont
vcv=vindictiive
vtu=vituperate
vcy=vicinity
vtun=vituperation
vdt=verdict
vtuv=vituperative
vet=veteran
vu=view
vf=verify
vud=viewed
vfn=verification
vug=viewing
vgc=vengeance
vul=vulgar
vgx=vigorous
vus=views
vk=victor
vx=violate
vka=victoria
vxd=violated
vkm=victim
vxg=vialating
vkn=vacation
vxn=violation
vkx=victorious
vy=very
vky=victory
vyj=voyage
vkz=victimize
vz=venezuela
vlj=village
vzn=venezuelan
vlr=volunteer
w=with
vly=voluntarily
wa=with a
vm=vehement
wac=with a capital
vmc=vehemence
wad=war department
vmy=vehemently
wnc=violence
wam=ways and means
vnq=vanish
wat=water
vnqd=vanished
wav=with a view
vnqg=vanishing
wb=will be
vnt=violent
wbh=will be held
wny=violently
wc=welcome
vo=vote
wcd=welcomed
voc=vocation
wcg=welcoming
vod=voted
wd=would
vog=voting
wda=wednesday
vol=volume
wdf=wonderful
vos=votes
wdg=weeding
wox=voluminous
wdw=withdraw
vp=vice president
wea=weather
vpot=vice president of the
wek=weak
vr=virtue
wg=wrong
wtl=wirtual
wgd=wronged
vru=virtuous
wgf=wrongful
vry=virtually
wgg=wronging
vsb=visible
wgh=weigh
wgt=weight
wgn=wagon
wgy=wrongly
wri=write
wrn=written
wh=whiche
wro=wrote
whi=while
wrk=work
whl=whole
wrt=with regard to
wht=wheat
wrx=works
whu=white house
ws=was
wi=will
wsk=whiskey
wig=willing
wsn=western
wik=wicked
wsp=warship
win=within
wsy=westerly
wis=wisconsin
wt=what
wit=witness
wtr=whether
witd=witnessed
wtv=whatever
witg=witnessing
wv=vaive
wix=wireless
wvd=waived
wj=wound
wyg=waiving
wk=week
ww=with which
wkm=workman
wx=wait
wkn=workmen
wxd=waited
wky=weekly
wxg=waiting
wl=well
wxr=waiter
wld=world
wy=why
wlf=welfare
x=in which
wlh=wealth
xac=exact
wly=wealthy
xag=exaggerate
wn=when
xas=exacts
wnb=will not be
xay=exactly
wnc=whence
xb=exorbitant
wng=winning
xby=exorbitantly
wnr=winner
xc=excite
wnv=whenever
xcd=excited
wo=who
xcg=exciting
wom=whom
xcm=excitement
wos=whose
xcp=except
wot=without
xcpn=exception
wp=weep
xd=exceed
wpg=weeping
xdd=exceeded
wpn=weapon
xdg=exceeding
wq=warrant
xdn=extradition
wqd=warranted
xdt=extradite
wqg=warranting
xdtd=extradited
wqs=warrants
xdtg=extraditing
wqy=warranty
xdy=exceedingly
wr=were
xg=legislate
wrd=word
xgd=legislated
wrg=writing
xgg=legislating
wrh=worth
xgh=extinguish
xghd=extinguished
xplg=exploding
xghg=extinguishing
xpln=explosion
xgn=legislation
xpm=experiment
xgor=legislator
xpn=expedition
xgr=legislature
xpo=expose
xgv=legislative
xpod=exposed
xh=exhaust
xpog=exposing
xhd=exhausted
xpon=exposition
xhg=exhausting
xpr=expenditure
xhn=exhaustion
xps=expense
xhv=exhaustive
xpt=export
xj=explain
xpv=expensive
xjd=explained
xr=exercise
xjg=explaining
xrd=exercised
xjn=explanation
xrg=exercising
xjy=explanatory
xrl=external
xk=execute
xrn=exertion
xkd=executed
xrs=exercises
xkn=execution
xrt=exert
xkr=executor
xs=exist
xkv=executive
xsc=existence
xl=excel
xsd=existed
xlc=excellence
xsg=existing
xlg=excelled
iss=exists
xlg=excelling
xt=extent
xlt=excellent
xtd=extend
xly=excellently
xtg=extending
xm=extreme
xtn=extension
xmt=exempt
xtv=extensive
xmtn=exemption
xty=extensively
xmy=extremely
xn=exclude
xun=exclusion
xnl=constitutional
xuv=exclusive
xnlst=constititionalist
xxd=cross examined
xnty=constitutionality
xxg=cross examining
xny=constitutionally
xxm=cross examine
xo=exoonerate
xxn=cross examination
xod=exonerated
tion
xog=exonerating
y=year
xon=exoneration
ya=yesterday
yoy=extraordinary
yaf=yesterday forenoon
xp=expense
xpc=experience
yam=yesterday morning
xpd=expend
xpg=expending
yap=yesterday afternoon
xpi=expedite
noon
xpl=explode
yav=yesterday evening
xpld=exploded
ing
yd=yield
yf=yellow fever
yl=yellow
yo=years old
yoa=years of age
z=from which
za=sea
zc=section
zcl=sectional
zd=said
zlx=zealous
zm=seem
zn=seen

